...............................................
.....%%.............??????????.................
%.............................................%
%@..........................%.................%
%.........E..*****%....E.E.%%....E...%%......O%
###############################################


