...............................................
.....%%........................................
%....................%%%......................%
%....................%@%....%.................%
%.........E..........%%%.E.......E...%%.......%
###############################################


