%%%%%%%%%%%%%%%%%%%%%%%%%%%%%%%%%%%%%%%%%%%%%%%
%.........??%%................................%
%...........................%.................%%%%%
%@...................%%%.E.......E...%%...E%......%
%%%%%%%%%%%%%%%...%%%%%%%%%%%%%%%%%%%%%%%%%%%%%...%
..............%...%...............................%
..............%...%...............................%
%%%%%%%%%%%%%%%...%%%%%%%%%%%%%%%%%%%%%%%%%%%%%...%
#..........%.................?**********..........%
#****.%%%%%%.................%%%%%%%%%%%%.****..%%
#?***.E..E....?...........?......E...E....***O#%%
###############################################

