...............................................
.....%%.............??????????.................
%.............................................%
%@..........................%.................%
%.........E.......%....E.E.%%....E...%%.......%
###############################################


