...............................................
...............................................
%.............................................%
%@..........................%.................%
%.........E.......%....E.E.%%....E...%%.......%
###############################################


